#...................#
.....................
...###############...
...#.............#...
...#.............#...
...#.............#...
...#.............#...
.....................
.....................
.....................
.....................
.....................
.....................
...#.............#...
...#.............#...
...#.............#...
...#.............#...
...###############...
.....................
#...................#