#..................#
....................
...###.......####...
..##........####....
..##......#####.....
..##.....####.......
...##....###........
...##....###........
...................#
...................#
...................#
....................
....................
.......######.......
......########......
....................
....................
...##############...
....................
####################