.....................
.....................
.....................
..........########...
.................#...
.................#...
.................#...
.................#...
.....................
.....................
.....................
.....................
.....................
...#.................
...#.................
...#.................
...#.................
...########..........
.....................
.....................
.....................